{
  "tileData": [
       [1, 1, 1, 1, 1, 1, 1, 1, 1, 1],
       [1, 1, 1, 1, 1, 1, 1, 1, 1, 1],
       [0, 0, 0, 0, 0, 0, 0, 0, 0, 0],
       [0, 0, 0, 0, 0, 0, 0, 0, 0, 0],
       [0, 0, 0, 0, 0, 0, 0, 0, 0, 0],
       [0, 0, 0, 0, 0, 0, 0, 0, 0, 0],
       [0, 0, 0, 0, 0, 2, 0, 0, 0, 0],
       [0, 0, 0, 0, 0, 0, 0, 0, 0, 0],
       [0, 0, 0, 0, 0, 0, 0, 0, 0, 0],
       [0, 0, 0, 0, 0, 0, 0, 0, 0, 0]
  ],
  "mapData": [
       [1, 1, 1, 1, 1, 1, 1, 1, 1, 1],
       [1, 1, 1, 1, 1, 1, 1, 1, 1, 1],
       [0, 1, 0, 1, 1, 1, 1, 1, 1, 0],
       [0, 0, 0, 0, 0, 0, 0, 0, 0, 0],
       [1, 0, 1, 1, 0, 0, 0, 0, 0, 1],
       [0, 0, 0, 0, 0, 0, 0, 0, 0, 0],
       [1, 0, 1, 0, 0, 0, 0, 1, 0, 1],
       [1, 0, 1, 0, 0, 0, 0, 0, 0, 1],
       [1, 0, 0, 1, 1, 1, 0, 0, 0, 0],
       [1, 0, 0, 1, 1, 1, 0, 0, 0, 0]
],
  "carMovedMapData": [
       [1, 1, 1, 1, 1, 1, 1, 1, 1, 1],
       [1, 1, 1, 1, 1, 1, 1, 1, 1, 1],
       [0, 1, 0, 1, 1, 1, 1, 1, 1, 0],
       [0, 0, 0, 0, 0, 0, 0, 0, 0, 0],
       [1, 0, 1, 1, 0, 0, 0, 0, 0, 1],
       [0, 0, 0, 0, 0, 0, 0, 0, 0, 0],
       [1, 0, 1, 0, 0, 0, 0, 1, 0, 1],
       [1, 0, 1, 0, 0, 0, 0, 0, 0, 1],
       [1, 0, 0, 0, 1, 0, 1, 1, 1, 1],
       [1, 0, 0, 0, 0, 0, 1, 1, 1, 1]
],
  "pigMovedMapData": [
       [1, 1, 1, 1, 1, 1, 1, 1, 1, 1],
       [1, 1, 1, 1, 1, 1, 1, 1, 1, 1],
       [0, 1, 0, 1, 1, 1, 1, 1, 0, 0],
       [0, 0, 0, 0, 0, 0, 0, 0, 0, 0],
       [1, 0, 1, 1, 0, 0, 0, 0, 0, 1],
       [0, 0, 0, 0, 0, 0, 0, 0, 0, 0],
       [1, 0, 1, 0, 0, 0, 0, 1, 0, 1],
       [1, 0, 1, 0, 0, 0, 0, 0, 0, 1],
       [1, 0, 0, 0, 1, 0, 1, 1, 1, 1],
       [1, 1, 0, 0, 0, 0, 1, 1, 1, 1]
],
  "tileSize": 64
}
